行動を代わる	に	 人間に
記述をする	と	 主体と
注目を集める	が	 サポートベクターマシンが
経験を行う	に を	 元に 学習を
-推論統計学習をする	て で に は を を通して	 なされて ACTRで 元に は ルールを 生成規則を通して
活躍敵対生成生成進化を見せる	て において は	 加えて 技術において 的ネットワークは
活躍敵対生成生成進化を活躍敵対生成生成進化をいる	て において は	 加えて 技術において 的ネットワークは
製作開発を行う	は	 エイダ・ラブレスは
処理を行う	に により	 Webに ティム・バーナーズリーにより
処理を処理をせる	に により	 Webに ティム・バーナーズリーにより
意味をする	に	 データに
付加処理を行う	て に	 して コンピュータに
付加処理を付加処理をせる	て に	 して コンピュータに
研究を進める	て	 費やして
命令をする	で	 機構で
運転をする	に	 元に
特許をする	が に まで	 日本が に 2018年まで
特許を特許をいる	が に まで	 日本が に 2018年まで
運転をする	て に	 基づいて 柔軟に
注目を集める	から は	 ことから ファジィは
制御を用いる	て も	 受けて 他社も
制御をする	から	 少なさから
処理改善を果たす	が で に	 チームが 画像コンテストで 2012年に
研究を続ける	が て	 ジェフホーキンスが 向けて
研究を研究をいる	が て	 ジェフホーキンスが 向けて
開発接地()をする	に は	 8月に は
注目を集める	に	 急速に
主導投資を行う	で に	 民間企業で 全世界的に
実装探索を行う	で	 無報酬で
推論をする	て	 経て
共同研究を始める	とも は	 マックスプランク研究所とも Googleは
共同研究を共同研究をおる	とも は	 マックスプランク研究所とも Googleは
研究を行う	て	 始めて
研究を研究をいる	て	 始めて
研究開発をする	で は	 官民一体で は
研究開発を研究開発をてる	で は	 官民一体で は
研究開発をする	で	 日本で
研究開発を研究開発をいる	で	 日本で
投資をする	に は まで	 に 韓国は 2022年まで
反乱を起こす	て に対して	 於いて 人間に対して
歩行監視を行う	に まで	 人工知能に 者まで
歩行監視を歩行監視をせる	に まで	 人工知能に 者まで
手続きを経る	を	 ウイグル族を
プログラム制御をする	は	 AIは
プログラム制御をプログラム制御をおる	は	 AIは
判断を介す	から	 観点から
禁止を求める	が に は	 ヒューマン・ライツ・ウォッチが 4月に は
禁止を禁止をいる	が に は	 ヒューマン・ライツ・ウォッチが 4月に は
開発競争を行う	は をめぐって	 米国中国ロシアは 軍事利用をめぐって
開発競争を開発競争をいる	は をめぐって	 米国中国ロシアは 軍事利用をめぐって
暴露拒否整合追及を受ける	て で と とともに は	 されて 性で すると とともに は
共同研究をする	が	 Microsoftが
発表解任をする	て は	 含まれて Google社員らは
要請解散をする	が で は	 倫理委員会が 理由で Googleは
存在を見いだす	に	 ものに
話をする	は	 哲学者は
話を話をいる	は	 哲学者は
議論を行う	まで	 これまで
議論を議論をくる	まで	 これまで
